1111111111111111111111111111111111111
1P00000000000000000000000000C00000001
1011111111111111111111111111111111111
1010000000000000000000000000000000001
1010001000000000000000000000000001001
1010001001111111111111111111000001001
1010001000000000000000000E01000001001
1010011111111111111111111111000001001
1010000000000000000000000000000001001
1011111111111111111111111111111111001
1000000000000000000000000000000000001
1111111111111111111111111111111111111