11111111111111111111111111111111
1P0000001E1C10000000000000000001
100001000000000010000000000000N1
10000000010000000000000000000001
10000000010000000000000000000001
11111111111111111111111111111111