111111111111111111111111111111111
1C00000000000000000000001000000E1
100000000000000000000000100000001
100000000000000000000000111111111
100000000000000000000000000000001
1P0000000000000000000000000000001
111111111111111111111111111111111