111111111111111111111111111111111
10PCE0000000000000000000000000001
100000000000000000000000000000001
100000000000000000000000000000001
100000000000000000000000000001
100000000000000000000000000000001
111111111111111111111111111111111